......a.
........
t......g
......tc
........
........
C.......
