....a.t.
........
t...g...
........
........
G..a...c
C..t...a
