......a.
........
t......g
......tC
........
........
C.......
