........
t...g...
..ca....
...CT...
..g....c
a......t
........
