.......a
........
t....g..
......ta
........
......C.
C.......
