t......a
.c....g.
..a..c..
...gt...
........
....gcta
CGTA....
