........
c....t.g
........
a..C.T..
........
g......a
........
