CtCtCtCt
........
.g......
..ca....
a....c..
...g...t
atcg....
