gC......
......a.
........
........
........
.g....t.
a......T
