..G..T..
........
........
.aaa....
a..a..a.
........
........
